#                              #
#                              #
#                              #
#                              #
#                              #
#                              #
#                              #
#                              #
#                              #
#                              #
#                              #
#                              #
#                              #
#                              #
#                              #
#                              #
#                            H #
################################